[
	{
		"tiles": [
			"#######",
			"#     #",
			"# ^   #",
			"#   # #",
			"##### #",
			"#@    #",
			"#######"
		]
	},
	{
		"tiles": [
			"########",
			"#   *  #",
			"# ^ *  #",
			"#   *  #",
			"#####  #",
			"#      #",
			"#@     #",
			"########"
		]
	},
	{
		"tiles": [
			"#########",
			"#      0#",
			"# #######",
			"# # #   #",
			"# # # # #",
			"# # # # #",
			"# # # # #",
			"#^#   #@#",
			"#########"
		],
		"buttons": [
			{
				"target": {"x": 3, "y": 2},
				"off": " ", "on": " "
			}
		]
	},
	{
		"tiles": [
			"##########",
			"#@# * * 0#",
			"## * * * #",
			"# * * * *#",
			"#* * * * #",
			"# * * * *#",
			"#* * * * #",
			"# * * *  #",
			"#1 * *  ^#",
			"##########"
		],
		"buttons": [
			{
				"target": {"x": 2, "y": 1},
				"off": " ", "on": " "
			},
			{
				"target": {"x": 1, "y": 2},
				"off": " ", "on": " "
			}
		]
	},
	{
		"tiles": [
			"###########",
			"#         #",
			"# ####### #",
			"# #     # #",
			"# # ### # #",
			"# # #^  # #",
			"# #*##### #",
			"# #       #",
			"# # #######",
			"#        @#",
			"###########"
		]
	},
	{
		"tiles": [
			"############",
			"#         @#",
			"#  #########",
			"##     *   #",
			"########## #",
			"# 0      # #",
			"#        # #",
			"#####*## # #",
			"#      # # #",
			"# ^    # # #",
			"#      #   #",
			"############"
		],
		"buttons": [
			{
				"target": {"x": 1, "y": 3},
				"off": "#", "on": " "
			}
		]
	},
	{
		"tiles": [
			"#############",
			"#0# #2# #4#@#",
			"# # # # # # #",
			"# # #*# # # #",
			"# # # # # # #",
			"# # # # #*# #",
			"#*# # # # # #",
			"# #*# # # # #",
			"# # # #*# # #",
			"# # # # # # #",
			"# # # # # # #",
			"#^#1# #3# # #",
			"#############"
		],
		"buttons": [
			{
				"target": {"x": 2, "y": 2},
				"off": "#", "on": " "
			},
			{
				"target": {"x": 4, "y": 4},
				"off": "#", "on": " "
			},
			{
				"target": {"x": 6, "y": 6},
				"off": "#", "on": " "
			},
			{
				"target": {"x": 8, "y": 8},
				"off": "#", "on": " "
			},
			{
				"target": {"x": 10, "y": 10},
				"off": "#", "on": " "
			}
		]
	},
	{
		"tiles": [
			"##############",
			"##2  * *   4##",
			"#0#   *    # #",
			"#  # *    #  #",
			"#^ *#    #   #",
			"# *  #  #    #",
			"#*    ##    *#",
			"#     ##   * #",
			"#    #  # * *#",
			"#   #    #   #",
			"#  #    * #  #",
			"#1#    *   #@#",
			"##3   * *  5##",
			"##############"
		],
		"buttons": [
			{
				"target": {"x": 9, "y": 4},
				"off": "#", "on": " "
			},
			{
				"target": {"x": 6, "y": 7},
				"off": "#", "on": " "
			},
			{
				"target": {"x": 7, "y": 6},
				"off": "#", "on": " "
			},
			{
				"target": {"x": 4, "y": 9},
				"off": "#", "on": " "
			},
			{
				"target": {"x": 9, "y": 9},
				"off": "#", "on": " "
			},
			{
				"target": {"x": 4, "y": 4},
				"off": "#", "on": " "
			}
		]
	},
	{
		"tiles": [
			"################",
			"#             1#",
			"# ############~#",
			"# #~~~~~~~~*~#~#",
			"# # *       ~#~#",
			"# #         ~#~#",
			"# #         ~#~#",
			"# #         ~#~#",
			"# #~~~      ~#0#",
			"# #~~~     *~#~#",
			"# #2~~      ~#~#",
			"##############~#",
			"#            #~#",
			"##@          #~#",
			"#^~~~~~~~~~~~~~#",
			"################"
		],
		"buttons": [
			{
				"target": {"x": 1, "y": 11},
				"off": "#", "on": " "
			},
			{
				"target": {"x": 7, "y": 2},
				"off": " ", "on": " "
			},
			{
				"target": {"x": 13, "y": 8},
				"off": "#", "on": " "
			}
		]
	}
]
